
NO maps/texture-2.xpm
SO maps/texture.xpm
WE maps/haifa.xpm
EA maps/Creeper-icon.xpm

111111111111111111111111111111111111
100000000000000000000000000000000001
100000000000000000000000000000000001
100000000000000000000000000000000001
100011110001111100011111000111100001
100011110001111100011111000111100001
100000110000001100000011000001100001
10000011000N001100000011000001100001
100000110000001100000011000001100001
100000110001111100011111000001100001
100000110001111100011111000001100001
100000110000001100000011000001100001
100000110000000110000001100000110001
100000110000001100000011000001100001
100000110001111100011111000001100001
100000110001111100011111000001100001
100000000000000000000000000000000001
100000000000000000000000000000000001
100000000000000000000000000000000001
111111111111111111111111111111111111
111111111111111111111111111111111111