

NO textures/north.xpm

SO textures/south.xpm
WE textures/west.xpm
EA textures/east.xpm
C       22,27,54
F       61,34,17


        1111111111111111111111111
        10000000001100000000000001
        101100000111000000000000001
		1001000000000000000000000001
1111111110110000011100000000000000001
1000000000110000011101111111111111111
11110111111111011100000010001
11110111111111011101010000001
11000000110101011100000010001
10001000000000001100000010001
100E100000000001101010010001
110000011101010111110111100111
11110111 1110101 1110100011111
11111111 1111111 1111111111111