
NO maps/texture-2.xpm
SO maps/texture.xpm
WE maps/haifa.xpm
EA maps/Creeper-icon.xpm

F 220,100,0
C 225,30,0

1111111111111111111111111
1000000000110000000000001
1011000001110000000000001
1001000N00000000000000001
111111111011000001110000000000001
100000000011000001110111111111111
11110111111111011100000010001
11110111111111011101010010001
11000000110101011100000010001
10011110000000001100000010001
10010100000000001101010010001
1101110111010101111101111000111
11110111 1110101 101111010001
11111111 1111111 111111111111

This is ignored