NO maps/texture.xpm
SO maps/texture.xpm
WE maps/texture.xpm
EA maps/texture.xpm

F 220,100,0
C 25,30,0


111111111111111111111111
1000000000110000000000001
1011000001110000100000001 
1001000000000000000000001
111111111011000001110000011111
100000000011000001110111111111111111111111111111111111111111111111111111111111111111111111111111111111111111111111111111111111111111111111111111111111111111111111111111111
11110111111111011100000010001
11110111111111011101010010001
110000001 10101011100000010001
11111111111111111111111111111111111111111111
1                             111
1                           1
111111111111111111111111111111111111111111111111111111
1000000100000011000000100011
100000000000000011010100100011
11000001110101011111011110N010111111111111111111111111
11110111 1110101 10111101000110100000000000000000000101
11111111 1111111 1111111111111111111111111111111111111


