NO maps/texture.xpm
SO maps/texture.xpm
WE maps/texture.xpm
EA maps/texture.xpm

F 220,100,0
C 255,30,0

1111111111111111111111111
1000000000110000000000001
1011000001110000000000001
1001000000000000000000001
1111111110110000011100000111111111
100000000011000001110111111111111
1111011111111101110000001000111111111111111111111111111111111111111111111111111111111111111111111111111111111111111111111111111111111111111111111111111111
1111011111111101110101001000101
1100000011010101110000001000111111111111111111111111111111111111111111111111111111111111111111111111111111111111111111111111111111111111111111111111
10000000000000001100000010001
10000000000000001101010010001
11000001110101011111011110N0111
111111111111111111111111111111111







