11111111111111111111111111111111111111111111111111111111
11111111111111111111111110111111111111111111111111111111
11111111111111111111111100011111111111111111111111111111
11111111111111111111111100011111111111111111111111111111
11111111111111111111111000001111111111111111111111111111
11111111011111111111111000001111111111111011111111111111
11111111001111111111111000001111111111111001111111111111
11111111000011111111110000000111111111100001111111111111
11111111000001111111110000000111111111000001111111111111
11111111000000111111110000000111111110000001111111111111
11111111100000011111110000000111111100000011111111111111
11111111100000001111110000000111111000000111111111111111
10111111110000000111110000000111110000000111111110111111
10011111110000000011110000000111100000000111111100111111
10000111111000000001110000000111000000001111110000111111
11000000111110000000110000000110000000011110000001111111
11110000000111100000010000000100000011100000001111111111
11111100000001111000000000000000001110000000111111111111
11111111000000000000000000000000000000000011111111111111
11111111111000000000000000000000000000001111111111111111
11111111111111000000000000000000000000111111111111111111
11111111111111111110000000000000111111111111111111111111
11111111111111111100000100010000011111111111111111111111
11111111111111111111111100011111111111111111111111111111
1111111111111111111111100N001111111111111111111111111111
11111111111111111111111110111111111111111111111111111111
11111111111111111111111111111111111111111111111111111111