

NO textures/north.xpm

SO textures/south.xpm
WE textures/west.xpm
EA textures/east.xpm
C       22,27,54   
F       61,34,17


1111111111111111111111111111111111111111111111111111111111111111111111111111111111111111
1000000000000000000000000000000000000000000000000000000000000000000000000000000000000001
1000000000000000000000000000000000000000000000000000000000000000000000000000000000000001
1E00000001000000000000000000010000000000000000100000000001000000000000000000000000000001
1000000000000000000000000000001000000000000001000000000010000000000000000000000000000001
1000000000000000000000000000000100000000000010000000000000000000000000000000000000000001
1000000000001100000000000000000000000000000000000000000000000000000000000000000000000001
1000000000001100000000000000000000000000000000000000000000000000000000000000000000000001
1111111111111111111111111111111111111111111111111111111111111111111111111111111111111111

This is ignored